_circuit	(no-literal-hosts-found)
_debug-trace	(no-literal-hosts-found)
_env	(no-literal-hosts-found)
_middleware	(no-literal-hosts-found)
_shared	(no-literal-hosts-found)
alpha-performance	(no-literal-hosts-found)
alpha-radar	stooq.com
analyst-stampede	finnhub.io
arb-breadth-lite	(no-literal-hosts-found)
arb-liquidity-pulse	api.stlouisfed.org
arb-risk-regime	stooq.com
breakout-energy	(no-literal-hosts-found)
central-bank-watch	www.ecb.europa.eu,www.federalreserve.gov
congress-trading	house-stock-watcher-data.s3-us-west-2.amazonaws.com
crypto-snapshot	api.coingecko.com
crypto	(no-literal-hosts-found)
dashboard	(no-literal-hosts-found)
debug-bundle	(no-literal-hosts-found)
debug-matrix	(no-literal-hosts-found)
diag	(no-literal-hosts-found)
earnings-calendar	finnhub.io
earnings-reality	(no-literal-hosts-found)
health-report	(no-literal-hosts-found)
health	(no-literal-hosts-found)
hype-divergence	www.reddit.com
insider-cluster	www.sec.gov
macro-rates	api.stlouisfed.org,query1.finance.yahoo.com
macro	(no-literal-hosts-found)
market-cockpit	api.alternative.me,api.coingecko.com,api.marketaux.com,cdn.cboe.com,financialmodelingprep.com,finnhub.io,home.treasury.gov,production.dataviz.cnn.io,query1.finance.yahoo.com
market-health	api.alternative.me,api.coingecko.com,production.dataviz.cnn.io,query1.finance.yahoo.com
market-regime	(no-literal-hosts-found)
news-intelligence	api.marketaux.com,feeds.reuters.com,finance.yahoo.com,search.cnbc.com
news	feeds.marketwatch.com,feeds.reuters.com,finance.yahoo.com,search.cnbc.com,www.nasdaq.com
og-image	www.w3.org
price-snapshot	api.coingecko.com
quotes	financialmodelingprep.com,finnhub.io,stooq.com
sector-rotation	financialmodelingprep.com,stooq.com
sentiment	finance.yahoo.com,search.cnbc.com
smart-money	(no-literal-hosts-found)
social-daily-brief	(no-literal-hosts-found)
social-runner	(no-literal-hosts-found)
sp500-sectors	stooq.com
tech-signals	stooq.com
top-movers	query1.finance.yahoo.com
volume-anomaly	(no-literal-hosts-found)
why-moved	(no-literal-hosts-found)
yield-curve	home.treasury.gov
